##################
X . . . . . . . .#
##         #   ###
##. . . . .#. . .#
## #   ### #   # #
##.#. . .#. . .#.#
## #     #   # # #
##.#. . . . .#.#.#
## ###     ### # #
##.#.#. . . .#.#.#
## # # #   # # # #
##. . M#. .#. . .#
#### # # # # ### #
##. .#. *#. .#. .#
## ###   ### # ###
##. . . . . . . .#
##################
