##################
X M#. . . . . . .#
## #       ### ###
##. * . . . . .#.#
##         #   # #
##. . . . .#. . .#
##       # #     #
##. . . .#. . . .#
## ### # # ###   #
##. . .#. . . . .#
## # # #     #   #
##.#.#. . . .#. .#
#### #   #   ### #
##. .#. .#. . . .#
#### #   ###     #
##. . . . .#. . .#
##################
