#############################
#. . . . .#. . . .#. . . . .#
##### # # # ### ##### ##### #
#.#.#.#.#.#.#. . . . .#. . . X
# # # ### # ### ########### #
#. . . . . . . . . . . . . .#
# # ### # # ### # # ##### # #
#.#.#. .#.#. . .#.#. . . .#.#
# # ### # # # # # ####### # #
#*#.#. .#.#.#.#.#. . . .#.#M#
# # # # # # # # # ##### # # #
#.#.#.#. .#.#. . . . . .#.#.#
# # # # # # # # # ##### # # #
#.#.#.#.#.#.#.#.#. . . .#.#.#
# # # # # # # # # ##### # # #
#.#.#.#.#.#.#.#.#. . . .#.#.#
# # # # # # # # # ##### # # #
#. . . . . . . . . . . . . .#
#############################
