#####X###########
##### ###########
#. . . . . .#. .#
# # ###   # # ###
#M#. .#. .#.#. .#
##### # ####### #
#.#. . .#.#. . .#
# # # # # #     #
#. .#.#. . . . .#
#   ###         #
#. . . . . . . .#
# #####   #     #
#. .#. . .#. . .#
#   #   # #   # #
#. . . .#. . .#.#
#       #   #####
#* . . . . . . .#
#################
