#############################
#. .#. . . . . . . .#. . . .#
# # # ### ##### # ### ##### #
#.#. . .#.#. . .#. .#.#.#.#.#
# ##### # # ### # ### # # # #
#. .#. . . . . . . .#.#. . .#
# # # ##### ### ### # # # # #
#.#. . . .#.#M . .#. .#.#.#.#
# # # # # # ### # # # # # # #
#.#.#.#.#.#. .#.#.#.#.#. . .#
# # # # # # # # # # # # #####
#. . . . .#.#. .#.#.#.#.#*#. X
# ####### # # # # # # # # # #
#. . . .#. . .#. . .#. . .#.#
##### # ##### # ### ### ### #
#.#.#.#.#. . .#. . . . . .#.#
# # # # ##### # # ####### # #
#. . . . . . . .#. . . . . .#
#############################
